1,2,3,4,5,6,7
2,3,4,5,6,7,6
3,4,5,6,7,6,5
4,5,6,7,6,5,4
5,6,7,6,5,4,3
6,7,6,5,4,3,2
7,6,5,4,3,2,1
