17,-7,17,-7,17,-7,17,-7,17,-7,17,-7
17,27,17,27,17,27,17,27,17,27,17,27
17,-7,17,-7,17,-7,17,-7,17,-7,17,-7
17,37,17,37,17,37,17,37,17,37,17,37
17,-7,17,-7,17,-7,17,-7,17,-7,17,-7
17,47,17,47,17,47,17,47,17,47,17,47
17,-7,17,-7,17,-7,17,-7,17,-7,17,-7
17,57,17,57,17,57,17,57,17,57,17,57
17,-7,17,-7,17,-7,17,-7,17,-7,17,-7
 1,-7, 1,-7, 1,-7, 1,-7, 1,-7, 1,-7
